3 3 3 3 3 3 3 3 3 3 3 3 3 3 3 3
3 3 3 7 1 1 1 1 1 1 1 1 8 3 3 3
3 3 3 8 1 1 1 1 1 1 1 1 7 3 3 3
3 3 3 9 1 1 7 8 7 9 1 1 9 3 3 3
3 8 7 10 1 1 3 3 3 3 1 1 9 8 7 3
4 1 1 1 1 1 1 1 1 1 1 1 1 1 1 4
4 1 1 1 1 1 1 1 1 1 1 1 1 1 1 4
3 7 8 9 1 1 3 3 3 3 1 1 11 8 9 3
3 3 3 8 1 1 9 9 7 8 1 1 7 3 3 3
3 3 3 9 1 1 1 1 1 1 1 1 8 3 3 3
3 3 3 7 1 1 1 1 1 1 1 1 9 3 3 3
3 3 3 3 3 3 3 3 3 3 3 3 3 3 3 3