3 3 3 3 3 3 3 3 3 3 3 3 3 3 3 3
3 7 8 9 7 8 8 7 9 6 7 8 8 7 9 3
3 9 1 1 1 1 1 1 1 1 1 1 1 1 8 3
3 7 1 1 1 1 1 1 1 1 1 1 1 1 9 3
3 8 1 1 3 3 3 3 3 3 3 3 3 3 3 3
3 9 1 1 1 1 1 1 1 1 1 1 1 1 1 4
3 8 1 1 1 1 1 1 1 1 1 1 1 1 1 4
3 8 1 1 3 3 3 3 3 3 3 3 3 3 3 3
3 7 1 1 1 1 1 1 1 1 1 1 1 1 7 3
3 9 1 1 1 1 1 1 1 1 1 1 1 1 9 3
3 7 7 8 9 8 7 9 9 7 8 12 7 9 8 3
3 3 3 3 3 3 3 3 3 3 3 3 3 3 3 3 
