3 3 3 3 3 3 3 3 3 3 3 3 3 3 3 3
3 7 8 9 9 8 7 7 8 9 9 8 7 7 8 3
3 8 0 0 0 0 0 0 0 0 0 0 0 0 0 3
3 7 0 0 0 0 0 0 0 0 0 0 0 0 0 3
3 8 0 0 0 0 0 0 0 0 0 0 0 4 4 3
3 9 1 1 1 1 1 1 1 1 1 1 1 1 4 3
3 7 1 1 1 1 1 1 1 1 1 1 1 1 4 3
3 8 0 0 0 0 0 0 0 0 0 0 0 4 4 3
3 7 0 0 0 0 0 0 0 0 0 0 0 0 0 3
3 9 0 0 0 0 0 0 0 0 0 0 0 0 0 3
3 8 7 7 9 8 7 8 9 9 8 7 9 7 8 3
3 3 3 3 3 3 3 3 3 3 3 3 3 3 3 3 