3 3 3 3 3 3 3 3 3 3 3 3 3 3 3 3 3 3 3 3 3 3 3 3 3 3 3 3 3 3 3 3 3 3 3 3 3 3 3 3 3 3 3 3 3 3 3 3 3 3 3 3 3 3 3 3 3 3 3 3 3 3 3 3 3 3 3 3 3 3 3 3 3 3 3 3 3 3 3 3 3 3 3 3 3 3 3 3 3 3 3 3 3 3 3 3 3 3 3 3 3 3 3 3 3 3 3 3 3 3 3 3
3 7 8 9 7 8 8 7 9 6 7 8 8 7 9 3 3 2 0 0 0 0 0 0 0 0 3 0 0 0 2 3 3 7 8 7 9 8 7 7 8 9 8 9 7 8 7 3 3 0 0 0 0 0 0 0 0 0 0 0 0 0 0 3 3 7 8 7 8 9 1 1 9 8 9 7 8 7 9 3 3 0 0 0 0 0 0 0 0 0 0 0 0 0 0 3 3 3 3 7 1 1 1 1 1 1 1 1 8 3 3 3
3 9 1 1 1 1 1 1 1 1 1 1 1 1 8 3 3 2 0 0 0 0 0 0 0 0 3 0 0 0 2 3 3 1 1 1 1 1 1 1 1 1 1 1 1 1 1 3 3 0 0 0 0 0 0 0 0 0 0 0 0 0 0 3 3 1 1 1 1 1 1 1 1 1 1 1 1 1 1 3 3 0 0 0 0 0 0 0 0 0 0 0 0 0 0 3 3 3 3 8 1 1 1 1 1 1 1 1 7 3 3 3
3 7 1 1 1 1 1 1 1 1 1 1 1 1 9 3 3 2 0 0 0 3 0 0 0 0 3 0 0 0 2 3 3 1 1 1 1 1 1 1 1 1 1 1 1 1 1 3 3 0 0 0 0 0 0 0 0 0 0 0 0 0 0 3 3 1 1 1 1 1 1 1 1 1 1 1 1 1 1 3 3 0 0 0 3 3 3 3 3 3 3 3 0 0 0 3 3 3 3 9 1 1 7 8 7 9 1 1 9 3 3 3
3 8 1 1 3 3 3 3 3 3 3 3 3 3 3 3 3 2 0 0 0 3 0 0 0 0 3 0 0 0 2 3 3 8 9 7 8 7 9 1 1 9 8 7 8 7 9 3 3 0 0 0 3 3 3 3 3 3 3 3 0 0 0 3 3 8 7 9 8 9 1 1 7 8 9 8 7 8 7 3 3 0 0 0 0 0 0 0 0 0 0 3 0 0 0 3 3 8 7 10 1 1 3 3 3 3 1 1 9 8 7 3
3 9 1 1 1 1 1 1 1 1 1 1 1 1 1 4 4 4 4 4 4 3 0 0 0 0 0 0 0 0 0 4 4 1 1 1 1 1 1 1 1 1 1 1 1 1 1 4 4 4 4 4 3 3 0 0 0 0 0 0 0 4 4 4 4 1 1 1 1 1 1 1 1 1 1 1 1 1 1 4 4 0 0 0 0 0 0 0 0 0 0 3 0 0 0 3 3 7 8 9 1 1 3 3 3 3 1 1 11 8 9 3
3 8 1 1 1 1 1 1 1 1 1 1 1 1 1 4 4 4 4 4 4 3 0 0 0 0 0 0 0 0 0 4 4 1 1 1 1 1 1 1 1 1 1 1 1 1 1 4 4 4 4 4 3 3 0 0 0 0 0 0 0 4 4 4 4 1 1 1 1 1 1 1 1 1 1 1 1 1 1 4 4 0 0 0 0 0 0 0 0 0 0 3 0 0 0 3 3 3 3 8 1 1 9 9 7 8 1 1 7 3 3 3
3 8 1 1 3 3 3 3 3 3 3 3 3 3 3 3 3 2 0 0 0 3 0 0 0 0 3 0 0 0 2 3 3 3 2 2 2 2 2 1 1 3 3 3 10 3 3 3 3 3 3 3 3 3 0 0 0 0 0 0 0 0 0 3 3 9 8 7 9 8 1 1 8 9 7 8 7 8 9 3 3 0 0 0 0 0 0 0 0 0 0 3 4 4 4 4 4 1 1 1 1 1 1 1 1 1 1 1 1 1 1 4
3 7 1 1 1 1 1 1 1 1 1 1 1 1 7 3 3 2 0 0 0 3 0 0 0 0 3 0 0 0 2 3 3 3 2 2 2 2 2 1 1 1 1 1 1 1 1 3 3 3 2 2 2 2 4 4 3 3 3 3 3 3 3 3 3 2 2 2 3 11 1 1 10 3 2 2 2 2 2 3 3 3 3 3 3 3 3 3 0 0 0 3 4 4 4 4 4 1 1 1 1 1 1 1 1 1 1 1 1 1 1 4
3 9 1 1 1 1 1 1 1 1 1 1 1 1 9 3 3 2 0 0 0 0 0 0 0 0 3 0 0 0 2 3 3 3 2 2 2 2 2 1 1 1 1 1 1 1 1 3 3 3 2 2 2 2 4 4 2 2 2 2 2 3 3 3 3 3 3 3 3 3 1 1 3 3 3 3 3 3 3 3 3 3 3 3 3 3 3 3 4 4 4 3 2 2 2 3 3 3 3 9 1 1 1 1 1 1 1 1 8 3 3 3
3 7 7 8 9 8 7 9 9 7 8 12 7 9 8 3 3 2 0 0 0 0 0 0 0 0 3 0 0 0 2 3 3 3 3 3 3 3 3 1 1 3 3 3 11 3 3 3 3 3 2 2 2 2 4 4 2 2 2 2 2 3 3 3 3 3 3 3 3 3 1 1 3 3 3 3 3 3 3 3 3 2 2 2 2 2 2 3 4 4 4 3 2 2 2 3 3 3 3 7 1 1 1 1 1 1 1 1 9 3 3 3
3 3 3 3 3 3 3 3 3 3 3 3 3 3 3 3 3 3 3 3 3 3 3 3 3 3 3 3 3 3 3 3 3 3 3 3 3 3 3 3 3 3 3 3 3 3 3 3 3 3 3 3 3 3 3 3 3 3 3 3 3 3 3 3 3 3 3 3 3 3 3 3 3 3 3 3 3 3 3 3 3 3 3 3 3 3 3 3 3 3 3 3 3 3 3 3 3 3 3 3 3 3 3 3 3 3 3 3 3 3 3 3