3 3 3 3 3 3 3 3 3 3 3 3 3 3 3 3
3 7 8 7 9 8 7 7 8 9 8 9 7 8 7 3
3 1 1 1 1 1 1 1 1 1 1 1 1 1 1 3
3 1 1 1 1 1 1 1 1 1 1 1 1 1 1 3
3 8 9 7 8 7 9 1 1 9 8 7 8 7 9 3
4 1 1 1 1 1 1 1 1 1 1 1 1 1 1 4
4 1 1 1 1 1 1 1 1 1 1 1 1 1 1 4
3 3 2 2 2 2 2 1 1 3 3 3 10 3 3 3
3 3 2 2 2 2 2 1 1 1 1 1 1 1 1 3
3 3 2 2 2 2 2 1 1 1 1 1 1 1 1 3
3 3 3 3 3 3 3 1 1 3 3 3 11 3 3 3
3 3 3 3 3 3 3 3 3 3 3 3 3 3 3 3 
