3 3 3 3 3 3 4 4 3 3 3 3 3 3 3 3
3 7 8 7 8 9 1 1 9 8 9 7 8 7 9 3
3 1 1 1 1 1 1 1 1 1 1 1 1 1 1 3
3 1 1 1 1 1 1 1 1 1 1 1 1 1 1 3
3 8 7 9 8 9 1 1 7 8 9 8 7 8 7 3
3 2 2 2 3 3 1 1 3 3 2 2 2 2 2 3
3 2 2 2 3 11 1 1 10 3 2 2 2 2 2 3
3 1 1 1 1 1 1 1 1 1 1 1 1 1 1 4
3 1 1 1 1 1 1 1 1 1 1 1 1 1 1 4
3 9 8 7 9 8 1 1 8 9 7 8 7 8 9 3
3 3 3 3 3 3 1 1 3 3 3 3 3 3 3 3
3 3 3 3 3 3 3 3 3 3 3 3 3 3 3 3