3 3 3 3 3 3 3 3 3 3 3 3 3 3 3 3
3 0 0 0 0 0 0 0 0 0 0 0 0 0 0 3
3 0 0 0 0 0 0 0 0 0 0 0 0 0 0 3
3 0 0 0 3 3 3 3 3 3 3 3 0 0 0 3
3 0 0 0 0 0 0 0 0 0 0 3 0 0 0 3
3 0 0 0 0 0 0 0 0 0 0 3 4 4 4 4
3 3 3 3 3 3 3 3 0 0 0 3 4 4 4 4
4 0 0 0 0 0 0 0 0 0 0 3 3 3 3 3
4 0 0 0 0 0 0 0 0 0 0 3 2 2 2 3
3 3 3 3 3 3 3 3 4 4 4 3 2 2 2 3
3 2 2 2 2 2 2 3 4 4 4 3 2 2 2 3
3 3 3 3 3 3 3 3 3 3 3 3 3 3 3 3